id,name,amount,account_name,completed_at,prev_balance,ending_balance
1,Groceries,200.0,Credit Union,2023-03-02T12:00:00,1000.0,800.0
2,Mortgage,2000.0,Credit Union,2023-03-05T12:00:00,800.0,-1200.0
3,Groceries,200.0,Credit Union,2023-03-09T12:00:00,-1200.0,-1400.0
4,Car Repair,400.0,Credit Union,2023-03-12T15:00:00,-1400.0,-1800.0
5,Groceries,200.0,Credit Union,2023-03-16T12:00:00,700.0,500.0
6,Groceries,200.0,Credit Union,2023-03-23T12:00:00,500.0,300.0
7,Co-pay,100.0,Credit Union,2023-03-25T12:00:00,300.0,200.0
8,Groceries,200.0,Credit Union,2023-03-30T12:00:00,200.0,0.0
