id,name,amount,account_name,completed_at,prev_balance,ending_balance
1,Groceries,200.0,Credit Union,2023-06-01T12:00:00,-600.0,-800.0
2,Mortgage,2000.0,Credit Union,2023-06-05T12:00:00,-800.0,-2800.0
3,Groceries,200.0,Credit Union,2023-06-08T12:00:00,-2800.0,-3000.0
4,Groceries,200.0,Credit Union,2023-06-15T12:00:00,-3000.0,-3200.0
5,Groceries,200.0,Credit Union,2023-06-22T12:00:00,-3200.0,-3400.0
6,Groceries,200.0,Credit Union,2023-06-29T12:00:00,-3400.0,-3600.0
